acquit	Acquit
Acquit	Acquit
appeal	Appeal
Appeal	Appeal
arrest-jail	Arrest-Jail
arrestjail	Arrest-Jail
arrestJail	Arrest-Jail
Arrest-Jail	Arrest-Jail
ArrestJail	Arrest-Jail
artifact	Artifact
Artifact	Artifact
attack	Attack
Attack	Attack
charge-indict	Charge-Indict
chargeindict	Charge-Indict
chargeIndict	Charge-Indict
Charge-Indict	Charge-Indict
ChargeIndict	Charge-Indict
convict	Convict
Convict	Convict
correspondence	Correspondence
Correspondence	Correspondence
declare-bankruptcy	Declare-Bankruptcy
declarebankruptcy	Declare-Bankruptcy
declareBankruptcy	Declare-Bankruptcy
Declare-Bankruptcy	Declare-Bankruptcy
DeclareBankruptcy	Declare-Bankruptcy
demonstrate	Demonstrate
Demonstrate	Demonstrate
die	Die
Die	Die
divorce	Divorce
Divorce	Divorce
elect	Elect
Elect	Elect
end-position	End-Position
endposition	End-Position
endPosition	End-Position
End-Position	End-Position
EndPosition	End-Position
execute	Execute
Execute	Execute
extradite	Extradite
Extradite	Extradite
fine	Fine
Fine	Fine
injure	Injure
Injure	Injure
marry	Marry
Marry	Marry
meet	Meet
Meet	Meet
merge-org	Merge-Org
mergeorg	Merge-Org
mergeOrg	Merge-Org
Merge-Org	Merge-Org
MergeOrg	Merge-Org
nominate	Nominate
Nominate	Nominate
pardon	Pardon
Pardon	Pardon
release-parole	Release-Parole
releaseparole	Release-Parole
releaseParole	Release-Parole
Release-Parole	Release-Parole
ReleaseParole	Release-Parole
sentence	Sentence
Sentence	Sentence
start-position	Start-Position
startposition	Start-Position
startPosition	Start-Position
Start-Position	Start-Position
StartPosition	Start-Position
sue	Sue
Sue	Sue
transfer-money	Transfer-Money
transfermoney	Transfer-Money
transferMoney	Transfer-Money
Transfer-Money	Transfer-Money
TransferMoney	Transfer-Money
transfer-ownership	Transfer-Ownership
transferownership	Transfer-Ownership
transferOwnership	Transfer-Ownership
Transfer-Ownership	Transfer-Ownership
TransferOwnership	Transfer-Ownership
transport-artifact	Transport-Artifact
transportartifact	Transport-Artifact
transportArtifact	Transport-Artifact
Transport-Artifact	Transport-Artifact
TransportArtifact	Transport-Artifact
transport-person	Transport-Person
transportperson	Transport-Person
transportPerson	Transport-Person
Transport-Person	Transport-Person
TransportPerson	Transport-Person
trial-hearing	Trial-Hearing
trialhearing	Trial-Hearing
trialHearing	Trial-Hearing
Trial-Hearing	Trial-Hearing
TrialHearing	Trial-Hearing
