Adjudicator	Adjudicator
adjudicator	Adjudicator
Agent	Agent
agent	Agent
Artifact	Artifact
artifact	Artifact
Attacker	Attacker
attacker	Attacker
Beneficiary	Beneficiary
beneficiary	Beneficiary
Crime	Crime
crime	Crime
Defendant	Defendant
defendant	Defendant
Destination	Destination
destination	Destination
Entity	Entity
entity	Entity
Giver	Giver
giver	Giver
Instrument	Instrument
instrument	Instrument
Money	Money
money	Money
Org	Org
org	Org
Origin	Origin
origin	Origin
Person	Person
person	Person
Plaintiff	Plaintiff
plaintiff	Plaintiff
Position	Position
position	Position
Prosecutor	Prosecutor
prosecutor	Prosecutor
Recipient	Recipient
recipient	Recipient
Sentence	Sentence
sentence	Sentence
Target	Target
target	Target
Victim	Victim
victim	Victim
Time	Time
time	Time
Place	Place
place	Place
