Agent	Agent
agent	Agent
Artifact	Artifact
artifact	Artifact
Attacker	Attacker
attacker	Attacker
Audience	Audience
audience	Audience
Beneficiary	Beneficiary
beneficiary	Beneficiary
Crime	Crime
crime	Crime
Destination	Destination
destination	Destination
Entity	Entity
entity	Entity
Giver	Giver
giver	Giver
Instrument	Instrument
instrument	Instrument
Money	Money
money	Money
Origin	Origin
origin	Origin
Person	Person
person	Person
Place	Place
place	Place
Position	Position
position	Position
Recipient	Recipient
recipient	Recipient
Target	Target
target	Target
Thing	Thing
thing	Thing
Time	Time
time	Time
Victim	Victim
victim	Victim
