COM	COM
com	COM
CRIME	CRIME
crime	CRIME
FAC	FAC
fac	FAC
GPE	GPE
gpe	GPE
LOC	LOC
loc	LOC
MONEY	MONEY
money	MONEY
ORG	ORG
org	ORG
PER	PER
per	PER
Time	Time
time	Time
Title	Title
title	Title
VEH	VEH
veh	VEH
WEA	WEA
wea	WEA
